0 1 0 17 21

1 2 7 61 24

 18  18  18  18  18  18  18  18  18  18  18  18  18  18  18  18  18  18  18  18  18
249 248 248 248 248 248 248 248 248 248 248 248 248 248 248 248 248 248 248 248 251
249  12  12 256  12  12  12  23 256  12  12  12 256  12  12  12  12 256  12  12 251
249   5   6   5   5   5   5   5   5   5   5   5   5   5   5   5   5   5   5   5 251
249   5 381   5   5   5   5   5   5   5   5   5   6 381   5   5   5   5   5   5 251
249   5   5   5   5   5   5   5   5   6   5   5   5   5   5   6   5   5   5   5 251
249   5   5   5   5   5   6   5   5   5   5   5   5   5   5   5   5   5   5   5 251
249   6   5   5   5   5   5 381   5   5   6   5   5   5   5   5   5   5   5   5 251
249   5   5   5   5   5   5   5   5   5   5   5   5   5   6   5   6   5   5   5 251
249   5   5   6 381   5   5   5   5   5   5   5   5   5   6   5   5   5   5   5 251
249   5   5   5   5   5   5   5   5   5   5   5   5   5   5   5   5   5   5   5 251
249   5   5   5   5   5   5   6   5   5   5   5   5   5   5   5   5   5   5   5 251
249   5   5   5   5   5   5   5   5   5   5   5 381   5   5   5   5   5   5   5 251
249   5   5   6   5   5   5   5   5   5   6   5   5   5   5   5   5   5   6   5 251
249   5   5   5   5   5   5   5   5   6   6   5   5   5   5   5 381   5   5   5 251
249 250 250 250 250 250 250 250 250 250  94 250 250 250 250 250 250 250 250 250 251
 18  18  18  18  18  18  18  18  18  18  18  18  18  18  18  18  18  18  18  18  18

 18  18  18  18  18  18  18  18  18  18  18  18  18  18  18  18  18  18  18  18  18
 18  12  12  12  12  12  12  12  12  12  12  12  12  12  12  12  12  12  12  12  18
 18  12  12  12  12  12  12   5  12  12  12  12  12  12  12  12  12  12  12  12  18
 18   5   5   5   5   5   5   5   5   5   5   5   5   5   5   5   5   5   5   5  18
 18   5   5   5   5   5   5   5   5   5   5   5   5   5   5   5   5   5   5   5  18
 18   5   5   5   5   5   5   5   5   5   5   5   5   5   5   5   5   5   5   5  18
 18   5   5   5   5   5   5   5   5   5   5   5   5   5   5   5   5   5   5   5  18
 18   5   5   5   5   5   5   5   5   5   5   5   5   5   5   5   5   5   5   5  18
 18   5   5   5   5   5   5   5   5   5   5   5   5   5   5   5   5   5   5   5  18
 18   5   5   5   5   5   5   5   5   5   5   5   5   5   5   5   5   5   5   5  18
 18   5   5   5   5   5   5   5   5   5   5   5   5   5   5   5   5   5   5   5  18
 18   5   5   5   5   5   5   5   5   5   5   5   5   5   5   5   5   5   5   5  18
 18   5   5   5   5   5   5   5   5   5   5   5   5   5   5   5   5   5   5   5  18
 18   5   5   5   5   5   5   5   5   5   5   5   5   5   5   5   5   5   5   5  18
 18   5   5   5   5   5   5   5   5   5   5   5   5   5   5   5   5   5   5   5  18
 18   5   5   5   5   5   5   5   5   5   5   5   5   5   5   5   5   5   5   5  18
 18  18  18  18  18  18  18  18  18  18  18  18  18  18  18  18  18  18  18  18  18

0

2
0 15 10 3  5 Dungeon24
1  2  7 9 18 Dungeon26

0

0

0

0

