1 1 0 50 50

1
17 30 18 1

141 142 141 142 141 142 141 142 141 142 141 142 141 142 141 142 141 142 141 142 141 142 141 142 141 142 141 142 141 142 141 142 141 142 141 142 141 142 141 142 141 142 141 142 141 142 179 179 179 141
145 146 145 146 145 146 145 146 145 146 145 146 145 146 145 146 145 146 145 146 145 146 145 146 145 146 145 146 145 146 145 146 145 146 145 146 145 146 145 146 145 146 145 146 145 146 152 153 154 145
141 142 141 142 141 142 141 142 141 142 141 142 141 142 141 142 141 142 141 142 141 142 141 142 141 142 141 142 141 142 141 142 141 142 141 142 141 142 141 142 141 142 141 142 141 142 152 153 154 141
139 140 139 140 139 140 139 140 139 140 139 140 139 140 139 140 139 140 139 140 139 140 139 140 139 140 139 140 139 140 139 140 139 140 139 140 139 140 139 140 139 140 139 140 139 140 152 153 154 145
179 169 169   1   1   1   1   1   1   1   1   1   1   1   1   1   1   1   1   1   1   1   1   1 170 171 174   1   1   1   1   1   1 171   1   1   1   1   1   1   1   1   1   1   1   1 152 153 154 141
179 157 157 157 157 157 157 157 157 157 157 157 157 157 157 157 157 157 157 157 157 157 157 157 157 157 157 157 157 157 157 157 157 157 157 157 157 157 157 157 157 157 157 157 157 157 156 153 154 145
179 153 153 153 153 153 153 153 153 153 153 153 153 153 153 153 153 153 153 153 153 153 153 153 153 153 153 153 153 153 153 153 153 153 153 153 153 153 153 153 153 153 153 153 153 153 153 153 154 141
179 149 149 149 149 149 149 149 149 149 149 149 149 149 149 149 149 149 149 149 149 149 149 149 149 149 149 149 149 149 149 149 149 149 149 149 149 149 149 149 149 149 149 149 149 149 149 149 150 139
179   1   1   1   1 172 171   1 172 171   1   1   1   1   1   1   1   1   1 127 128 129   1   1   1   1 171   1   1 173   1 172   1   1   1   1   1   1 174   1   1   1   1 171   1   1   1   1   1 191
  2   2   2   2   2   2   2   2   2   2   2   2   2   2   2   2   2   2   2 125 123 126   2   2   2   2   2   2   2   2   2   2   2   2   2   2   2   2   2   2   2   2   2   2   2   2   2   2   2   2
  2   2   2   2   2   2   2   2   2   2   2   2   2   2   2   2   2   2   2 122 123 124   2   2   2   2   2   2   2   2   2   2   2   2   2   2   2   2   2   2   2   2   2   2   2   2   2   2   2   2
143 144 143 144   2   2   2   2   2   2   2   2   2   2   2   2   2   2   2 125 123 126   2   2   2   2   2   2   2   2   2   2   2   2   2   2   2   2   2   2   2   2   2   2   2   2 143 144 143 144
141 142 141 142 174   1   1   1   1   1   1   1   1   1   1   1 173   1   1 119 120 121   1   1   1   1   1   1   1   1   1   1   1   1   1   1   1   1   1   1   1   1   1   1   1   1 141 142 141 142
145 146 145 146   1   1 174   1   1   1   1   1 173   1   1   1   1   1   1 155 157 158   1   1   1   1   1   1   1   1   1   1   1 171   1   1 172   1   1   1   1   1   1   1   1   1 145 146 145 146
141 142 141 142   1   1   1   1   1   1   1   1   1   1   1   1   1 171   1 152 153 154   1   1   1   1   1   1  62  63  68  67   1   1   1   1   1   1   1   1   1 172   1   1   1   1 141 142 141 142
145 146 145 146   1   1   1   1   1   1   1   1   1   1   1   1   1   1   1 152 153 154   1   1   1   1   1   1  61  61  66  66   1   1   1   1   1   1   1 171   1   1   1   1 173   1 145 146 145 146
141 142 141 142   1   1   1   1   1   1   1   1   1   1   1 174   1   1   1 152 153 154   1   1   1   1   1   1  59  60  65  64   1   1   1   1   1   1   1   1   1   1   1   1   1   1 141 142 141 142
145 146 145 146   1   1 171   1   1   1   1   1   1   1   1   1   1 171   1 152 153 154   1   1   1   1 173   1  70  74 245  69   1   1   1   1   1   1   1   1   1   1   1   1   1   1 145 146 145 146
141 142 141 142   1   1   1   1   1   1   1   1   1   1   1   1   1   1 171 152 153 154   1 171   1 172   1   1   1   1 173   1   1   1   1   1   1   1   1   1   1   1   1   1   1   1 141 142 141 142
145 146 145 146   1   1   1   1   1   1   1   1   1   1   1   1   1   1   1 152 153 154   1   1   1   1   1   1   1   1   1   1   1 173   1   1   1   1   1   1   1   1   1   1   1   1 145 146 145 146
141 142 141 142   1 172   1   1   1   1   1   1   1   1   1   1   1   1   1 152 153 154   1   1   1 172   1   1 171   1 174   1   1   1   1   1   1   1   1   1   1   1   1   1   1   1 141 142 141 142
145 146 145 146 174   1 174   1 173   1   1   1   1   1   1   1   1   1   1 152 153 154   1   1   1   1   1   1   1   1 172   1 171   1   1 171   1   1   1   1   1   1   1   1   1   1 139 140 139 140
141 142 141 142   1   1   1   1   1   1   1   1 172   1 172   1   1   1   1 152 153 159 157 157 157 157 157 157 157 157 157 157 157 157 157 157 157 157 157 157 157 157 157 157 157 157 157 157 157 179
145 146 145 146   1   1   1   1   1   1   1   1   1   1   1   1 169   1   1 152 153 153 153 153 153 153 153 153 153 153 153 153 153 153 153 153 153 153 153 153 153 153 153 153 153 153 153 153 153 179
141 142 141 142   1   1   1   1   1   1   1   1   1   1   1   1   1   1   1 152 153 151 149 149 149 149 149 149 149 149 149 149 149 149 149 149 149 149 149 149 149 149 149 149 149 149 149 149 149 179
145 146 145 146   1   1   1 172   1   1   1   1   1   1   1   1   1   1   1 152 153 154   1   1 171   1   1   1   1   1   1   1   1   1   1   1 169   1 174   1 172   1   1 171   1   1 143 144 143 144
141 142 141 142   1   1   1   1   1   1   1   1   1   1   1   1   1   1   1 152 153 154   1   1   1   1   1   1   1   1   1   1   1   1   1   1   1   1   1   1 172 174   1   1   1   1 141 142 141 142
145 146 145 146   1   1   1   1   1   1   1   1   1   1   1   1   1   1   1 152 153 154   1   1 171   1   1   1   1   1   1 171   1   1   1   1   1 173   1   1   1   1 172   1   1   1 145 146 145 146
141 142 141 142   1   1   1   1   1   1   1   1   1   1   1   1   1   1   1 152 153 154   1   1   1   1   1   1   1   1   1 169 172   1   1   1   1   1   1   1   1   1   1   1   1   1 141 142 141 142
145 146 145 146   1   1   1   1   1   1   1 173   1   1   1   1   1   1   1 152 153 154   1   1 172   1   1   1   1   1   1   1   1   1   1   1   1   1   1   1   1   1   1   1   1   1 145 146 145 146
141 142 141 142   1   1   1   1   1   1   1   1   1   1   1   1   1   1 172 152 153 154   1   1   1   1   1   1 174   1   1   1 173   1   1   1   1   1   1   1   1   1   1   1   1   1 141 142 141 142
145 146 145 146   1   1   1 174   1   1 174   1   1 174   1   1   1   1   1 152 153 154   1   1   1   1   1 171   1 172   1 173   1   1   1   1   1   1   1   1   1   1   1   1   1   1 145 146 145 146
141 142 141 142 173   1   1 171   1   1   1   1   1   1   1 173   1   1   1 152 153 154 172   1   1   1   1   1   1   1   1   1   1   1   1   1   1   1   1   1 171   1   1   1   1   1 141 142 141 142
145 146 145 146   1 173 174   1   1   1   1   1   1   1   1   1   1   1   1 152 153 154   1   1   1   1   1   1   1   1   1   1   1   1   1   1 172   1   1   1   1   1   1   1   1   1 145 146 145 146
141 142 141 142   1 173   1   1   1   1   1   1 174   1   1   1   1   1   1 152 153 154   1   1   1   1 172 169 174   1   1 171   1 172   1   1   1   1 171 174   1   1   1   1   1   1 141 142 141 142
145 146 145 146   1   1   1   1   1   1   1   1   1   1   1   1   1   1   1 152 153 154   1   1   1   1   1   1   1 174   1   1   1   1   1   1   1   1   1   1   1   1   1   1   1   1 145 146 145 146
141 142 141 142   1   1   1   1   1   1   1   1 173   1   1   1   1   1   1 152 153 154   1   1   1   1   1 171   1   1   1   1   1   1   1   1   1 171   1   1   1   1 171   1   1   1 141 142 141 142
139 140 139 140 173   1   1   1 172   1 174   1 171   1   1   1   1   1   1 152 153 154   1   1   1   1   1   1   1 171   1   1   1   1   1 172   1   1   1   1   1   1   1   1   1   1 145 146 145 146
179 157 157 157 157 157 157 157 157 157 157 157 157 157 157 157 157 157 157 156 153 154   1   1   1   1   1   1   1   1   1   1   1   1   1   1   1   1   1   1   1   1   1   1   1   1 141 142 141 142
179 153 153 153 153 153 153 153 153 153 153 153 153 153 153 153 153 153 153 153 153 154   1   1   1   1   1   1   1   1   1   1   1   1   1   1   1   1   1   1   1   1   1   1   1   1 145 146 145 146
179 149 149 149 149 149 149 149 149 149 149 149 149 149 149 149 149 149 149 148 153 154   1   1   1   1   1   1 172   1   1   1   1   1   1 174   1   1   1   1   1   1   1   1   1   1 141 142 141 142
143 144 143 144   1   1   1   1 174   1   1   1   1 174   1   1   1   1 173 152 153 154   1   1   1   1   1   1   1   1   1   1 172   1   1   1   1   1 171   1   1 171   1   1 171   1 145 146 145 146
141 142 141 142   1   1   1 171   1   1 173   1   1 173   1   1   1 172   1 152 153 154   1   1   1   1   1   1   1   1   1   1 173   1   1   1   1   1   1   1   1   1   1   1   1   1 141 142 141 142
145 146 145 146   1   1   1   1   1   1   1   1   1   1 169   1   1   1   1 152 153 154   1   1   1   1   1   1   1   1   1   1   1   1   1   1   1   1 171 174   1   1   1   1   1   1 145 146 145 146
141 142 141 142   1   1   1   1   1   1   1   1 169   1   1   1   1   1   1 152 153 154   1   1   1   1   1   1   1   1   1   1   1   1   1 171   1   1   1   1   1   1   1   1   1   1 141 142 141 142
145 146 145 146   1   1   1   1   1   1   1   1   1   1 171   1   1   1   1 152 153 154   1   1   1   1   1   1   1   1   1   1 171   1   1   1   1   1   1   1 171   1   1   1   1   1 145 146 145 146
141 142 141 142 172   1   1   1   1   1 169 174   1   1   1   1   1   1   1 152 153 154   1 173   1   1   1   1   1   1   1   1   1   1   1   1   1 170   1 174 171   1   1   1   1   1 141 142 141 142
145 146 145 146   1   1   1   1   1   1   1   1   1   1   1   1   1 173   1 152 153 154   1   1   1   1 173   1 174   1   1   1   1 174   1   1   1   1   1   1   1   1   1   1   1   1 145 146 145 146
141 142 141 142   1   1   1   1   1   1   1   1   1 172   1   1   1   1   1 152 153 154   1   1 171   1   1   1   1   1   1   1   1   1   1   1   1   1   1   1   1   1 173   1   1   1 141 142 141 142
145 146 145 146   1   1   1   1   1   1   1   1   1   1   1 169   1   1   1 147 149 150   1   1   1   1   1   1   1 171   1   1   1 174   1   1   1   1   1   1   1   1   1   1   1 174 145 146 145 146

  1   1   1   1   1   1   1   1   1   1   1   1   1   1   1   1   1   1   1   1   1   1   1   1   1   1   1   1   1   1   1   1   1   1   1   1   1   1   1   1   1   1   1   1   1   1 152 153 154   1
  1   1   1   1   1   1   1   1   1   1   1   1   1   1   1   1   1   1   1   1   1   1   1   1   1   1   1   1   1   1   1   1   1   1   1   1   1   1   1   1   1   1   1   1   1   1 152 153 154   1
  1   1   1   1   1   1   1   1   1   1   1   1   1   1   1   1   1   1   1   1   1   1   1   1   1   1   1   1   1   1   1   1   1   1   1   1   1   1   1   1   1   1   1   1   1   1 152 153 154   1
  1   1   1   1   1   1   1   1   1   1   1   1   1   1   1   1   1   1   1   1   1   1   1   1   1   1   1   1   1   1   1   1   1   1   1   1   1   1   1   1   1   1   1   1   1   1 152 153 154   1
  1   1   1   1   1   1   1   1   1   1   1   1   1   1   1   1   1   1   1   1   1   1   1   1   1   1   1   1   1   1   1   1   1   1   1   1   1   1   1   1   1   1   1   1   1   1 152 153 154   1
157 157 157 157 157 157 157 157 157 157 157 157 157 157 157 157 157 157 157 157 157 157 157 157 157 157 157 157 157 157 157 157 157 157 157 157 157 157 157 157 157 157 157 157 157 157 156 157 154   1
153 153 153 153 153 153 153 153 153 153 153 153 153 153 153 153 153 153 153 153 153 153 153 153 153 153 153 153 153 153 153 153 153 153 153 153 153 153 153 153 153 153 153 153 153 153 153 153 154   1
149 149 149 149 149 149 149 149 149 149 149 149 149 149 149 149 149 149 149 149 149 149 149 149 149 149 149 149 149 149 149 149 149 149 149 149 149 149 149 149 149 149 149 149 149 149 149 149 150   1
  1   1   1   1   1   1   1   1   1   1   1   1   1   1   1   1   1   1   1   1   1   1   1   1   1   1   1   1   1   1   1   1   1   1   1   1   1   1   1   1   1   1   1   1   1   1   1   1   1   1
160 161 161 161 161 161 161 161 161 161 161 161 161 161 161 161 161 161 161 161 161 161 161 161 161 161 161 161 161 161 161 161 161 161 161 161 161 161 161 161 161 161 161 161 161 161 161 161 161 162
163 164 164 164 164 164 164 164 164 164 164 164 164 164 164 164 164 164 164 164 164 164 164 164 164 164 164 164 164 164 164 164 164 164 164 164 164 164 164 164 164 164 164 164 164 164 164 164 164 165
166 167 167 167 167 167 167 167 167 167 167 167 167 167 167 167 167 167 167 167 167 167 167 167 167 167 167 167 167 167 167 167 167 167 167 167 167 167 167 167 167 167 167 167 167 167 167 167 167 168
  1   1   1   1   1   1   1   1   1   1   1   1   1   1   1   1   1   1   1   1   1   1   1   1   1   1   1   1   1   1   1   1   1   1   1   1   1   1   1   1   1   1   1   1   1   1   1   1   1   1
  1   1   1   1   1   1   1   1   1   1   1   1   1   1   1   1   1   1   1   1   1   1   1   1   1   1   1   1   1   1   1   1   1   1   1   1   1   1   1   1   1   1   1   1   1   1   1   1   1   1
  1   1   1   1   1   1   1   1   1   1   1   1   1   1   1   1   1   1   1   1   1   1   1   1   1   1   1   1   1   1   1   1   1   1   1   1   1   1   1   1   1   1   1   1   1   1   1   1   1   1
  1   1   1   1   1   1   1   1   1   1   1   1   1   1   1   1   1   1   1   1   1   1   1   1   1   1   1   1   1   1   1   1   1   1   1   1   1   1   1   1   1   1   1   1   1   1   1   1   1   1
  1   1   1   1   1   1   1   1   1   1   1   1   1   1   1   1   1   1   1   1   1   1   1   1   1   1   1   1   1   1   1   1   1   1   1   1   1   1   1   1   1   1   1   1   1   1   1   1   1   1
  1   1   1   1   1   1   1   1   1   1   1   1   1   1   1   1   1   1   1   1   1   1   1   1   1   1   1   1   1   1   1   1   1   1   1   1   1   1   1   1   1   1   1   1   1   1   1   1   1   1
  1   1   1   1   1   1   1   1   1   1   1   1   1   1   1   1   1   1   1   1   1   1   1   1   1   1   1   1   1   1   1   1   1   1   1   1   1   1   1   1   1   1   1   1   1   1   1   1   1   1
  1   1   1   1   1   1   1   1   1   1   1   1   1   1   1   1   1   1   1   1   1   1   1   1   1   1   1   1   1   1   1   1   1   1   1   1   1   1   1   1   1   1   1   1   1   1   1   1   1   1
  1   1   1   1   1   1   1   1   1   1   1   1   1   1   1   1   1   1   1   1   1   1   1   1   1   1   1   1   1   1   1   1   1   1   1   1   1   1   1   1   1   1   1   1   1   1   1   1   1   1
  1   1   1   1   1   1   1   1   1   1   1   1   1   1   1   1   1   1   1   1   1   1   1   1   1   1   1   1   1   1   1   1   1   1   1   1   1   1   1   1   1   1   1   1   1   1   1   1   1   1
  1   1   1   1   1   1   1   1   1   1   1   1   1   1   1   1   1   1   1   1   1   1   1   1   1   1   1   1   1   1   1   1   1   1   1   1   1   1   1   1   1   1   1   1   1   1 157 157 157 157
  1   1   1   1   1   1   1   1   1   1   1   1   1   1   1   1   1   1   1   1   1   1   1   1   1   1   1   1   1   1   1   1   1   1   1   1   1   1   1   1   1   1   1   1   1   1 153 153 153 153
  1   1   1   1   1   1   1   1   1   1   1   1   1   1   1   1   1   1   1   1   1   1   1   1   1   1   1   1   1   1   1   1   1   1   1   1   1   1   1   1   1   1   1   1   1   1 149 149 149 149
  1   1   1   1   1   1   1   1   1   1   1   1   1   1   1   1   1   1   1   1   1   1   1   1   1   1   1   1   1   1   1   1   1   1   1   1   1   1   1   1   1   1   1   1   1   1   1   1   1   1
  1   1   1   1   1   1   1   1   1   1   1   1   1   1   1   1   1   1   1   1   1   1   1   1   1   1   1   1   1   1   1   1   1   1   1   1   1   1   1   1   1   1   1   1   1   1   1   1   1   1
  1   1   1   1   1   1   1   1   1   1   1   1   1   1   1   1   1   1   1   1   1   1   1   1   1   1   1   1   1   1   1   1   1   1   1   1   1   1   1   1   1   1   1   1   1   1   1   1   1   1
  1   1   1   1   1   1   1   1   1   1   1   1   1   1   1   1   1   1   1   1   1   1   1   1   1   1   1   1   1   1   1   1   1   1   1   1   1   1   1   1   1   1   1   1   1   1   1   1   1   1
  1   1   1   1   1   1   1   1   1   1   1   1   1   1   1   1   1   1   1   1   1   1   1   1   1   1   1   1   1   1   1   1   1   1   1   1   1   1   1   1   1   1   1   1   1   1   1   1   1   1
  1   1   1   1   1   1   1   1   1   1   1   1   1   1   1   1   1   1   1   1   1   1   1   1   1   1   1   1   1   1   1   1   1   1   1   1   1   1   1   1   1   1   1   1   1   1   1   1   1   1
  1   1   1   1   1   1   1   1   1   1   1   1   1   1   1   1   1   1   1   1   1   1   1   1   1   1   1   1   1   1   1   1   1   1   1   1   1   1   1   1   1   1   1   1   1   1   1   1   1   1
  1   1   1   1   1   1   1   1   1   1   1   1   1   1   1   1   1   1   1   1   1   1   1   1   1   1   1   1   1   1   1   1   1   1   1   1   1   1   1   1   1   1   1   1   1   1   1   1   1   1
  1   1   1   1   1   1   1   1   1   1   1   1   1   1   1   1   1   1   1   1   1   1   1   1   1   1   1   1   1   1   1   1   1   1   1   1   1   1   1   1   1   1   1   1   1   1   1   1   1   1
  1   1   1   1   1   1   1   1   1   1   1   1   1   1   1   1   1   1   1   1   1   1   1   1   1   1   1   1   1   1   1   1   1   1   1   1   1   1   1   1   1   1   1   1   1   1   1   1   1   1
  1   1   1   1   1   1   1   1   1   1   1   1   1   1   1   1   1   1   1   1   1   1   1   1   1   1   1   1   1   1   1   1   1   1   1   1   1   1   1   1   1   1   1   1   1   1   1   1   1   1
  1   1   1   1   1   1   1   1   1   1   1   1   1   1   1   1   1   1   1   1   1   1   1   1   1   1   1   1   1   1   1   1   1   1   1   1   1   1   1   1   1   1   1   1   1   1   1   1   1   1
  1   1   1   1   1   1   1   1   1   1   1   1   1   1   1   1   1   1   1   1   1   1   1   1   1   1   1   1   1   1   1   1   1   1   1   1   1   1   1   1   1   1   1   1   1   1   1   1   1   1
157 157 157 157 157 157 157 157 157 157 157 157 157 157 157 157 157 157 157   1   1   1   1   1   1   1   1   1   1   1   1   1   1   1   1   1   1   1   1   1   1   1   1   1   1   1   1   1   1   1
153 153 153 153 153 153 153 153 153 153 153 153 153 153 153 153 153 153 153   1   1   1   1   1   1   1   1   1   1   1   1   1   1   1   1   1   1   1   1   1   1   1   1   1   1   1   1   1   1   1
149 149 149 149 149 149 149 149 149 149 149 149 149 149 149 149 149 149 149   1   1   1   1   1   1   1   1   1   1   1   1   1   1   1   1   1   1   1   1   1   1   1   1   1   1   1   1   1   1   1
  1   1   1   1   1   1   1   1   1   1   1   1   1   1   1   1   1   1   1   1   1   1   1   1   1   1   1   1   1   1   1   1   1   1   1   1   1   1   1   1   1   1   1   1   1   1   1   1   1   1
  1   1   1   1   1   1   1   1   1   1   1   1   1   1   1   1   1   1   1   1   1   1   1   1   1   1   1   1   1   1   1   1   1   1   1   1   1   1   1   1   1   1   1   1   1   1   1   1   1   1
  1   1   1   1   1   1   1   1   1   1   1   1   1   1   1   1   1   1   1   1   1   1   1   1   1   1   1   1   1   1   1   1   1   1   1   1   1   1   1   1   1   1   1   1   1   1   1   1   1   1
  1   1   1   1   1   1   1   1   1   1   1   1   1   1   1   1   1   1   1   1   1   1   1   1   1   1   1   1   1   1   1   1   1   1   1   1   1   1   1   1   1   1   1   1   1   1   1   1   1   1
  1   1   1   1   1   1   1   1   1   1   1   1   1   1   1   1   1   1   1   1   1   1   1   1   1   1   1   1   1   1   1   1   1   1   1   1   1   1   1   1   1   1   1   1   1   1   1   1   1   1
  1   1   1   1   1   1   1   1   1   1   1   1   1   1   1   1   1   1   1   1   1   1   1   1   1   1   1   1   1   1   1   1   1   1   1   1   1   1   1   1   1   1   1   1   1   1   1   1   1   1
  1   1   1   1   1   1   1   1   1   1   1   1   1   1   1   1   1   1   1   1   1   1   1   1   1   1   1   1   1   1   1   1   1   1   1   1   1   1   1   1   1   1   1   1   1   1   1   1   1   1
  1   1   1   1   1   1   1   1   1   1   1   1   1   1   1   1   1   1   1   1   1   1   1   1   1   1   1   1   1   1   1   1   1   1   1   1   1   1   1   1   1   1   1   1   1   1   1   1   1   1
  1   1   1   1   1   1   1   1   1   1   1   1   1   1   1   1   1   1   1   1   1   1   1   1   1   1   1   1   1   1   1   1   1   1   1   1   1   1   1   1   1   1   1   1   1   1   1   1   1   1

0

14
0  4  0  5 12 The Stables Western Exit
0  5  0  6 12 The Stables Western Exit
0  6  0  7 12 The Stables Western Exit
0  7  0  8 12 The Stables Western Exit
0  8  0  9 12 The Stables Western Exit
0 38  0 38 12 The Stables Western Exit
0 39  0 39 12 The Stables Western Exit
0 40  0 40 12 The Stables Western Exit
0 41  0 41 12 The Stables Western Exit
1 17 30 15  9 Tavern
0 22 49 22  1 The Dark Forest
0 23 49 23  1 The Dark Forest
0 24 49 24  1 The Dark Forest
0 25 49 25  1 The Dark Forest

1
0 17 30 18

0
0
0
0
1
0 17 30 Tavern Door
