1 1 0 17 21
0
 18  18  18  18  18  18  18  18  18  18  18  18  18  18  18  18  18  18  18  18  18
249 248 248 248 248 248 248 248 248 248 248 248 248 248 248 248 248 248 248 248 251
249 284 280 280 280 280 285  12  12  12  12  12  12  12  12  12  12  12  12  12 251
249 284 280 280 280 280 285   5   5   5   5   5   5   5   5   5   5   5   5   5 251
249   5   5   5   5   5   5   5   5   5   5   5   5   5   5   5   5   5   5   5 251
249   5   5   5   5   5   5   5   5   5   5   5   5   5   5   5   5   5   5   5 251
249   5   5   5   5   5   5   5   5   5   5   5 267 268 268 268 269   5   5   5 251
249   5   5 267 268 269   5   5   5   5   5   5 270 271 271 271 272   5   5   5 251
249   5   5 270 271 272   5   5   5   5   5   5 270 271 271 271 272   5   5   5 251
249   5   5 270 271 272   5   5   5   5   5   5 273 274 274 274 275   5   5   5 251
249   5   5 270 271 272   5   5   5   5   5   5   5   5   5   5   5   5   5   5 251
249   5   5 270 271 272   5   5   5   5   5   5   5   5   5   5   5   5   5   5 251
249   5   5 273 274 275   5   5   5   5   5   5   5   5   5   5   5   5   5   5 251
249   5   5   5   5   5   5   5   5   5   5   5   5   5   5   5   5   5   5   5 251
249   5   5   5   5   5   5   5   5   5   5   5   5   5   5   5   5   5   5   5 251
249 250 250 250 250 250 250 250 250  94 250 250 250 250 250 250 250 250 250 250 251
 18  18  18  18  18  18  18  18  18  18  18  18  18  18  18  18  18  18  18  18  18

  5   5   5   5   5   5   5   5   5   5   5   5   5   5   5   5   5   5   5   5   5
 18 282 281 281 281 281 283  12  12  12  12  12  12  12  12  12  12  12  12  12  18
 18   5   5   5   5   5   5   5   5   5   5   5   5   5   5   5   5   5   5   5  18
 18   5   5   5   5   5   5   5   5   5   5   5   5   5   5   5   5   5   5   5  18
 18   5   5   5   5   5   5   5   5   5   5   5   5   5   5   5   5   5   5   5  18
 18   5   5   5   5   5   5   5   5   5   5   5   5   5   5   5   5   5   5   5  18
 18   5   5   5   5   5   5   5   5   5   5   5   5   5 279   5   5   5   5   5  18
 18   5   5   5   5   5   5   5   5   5   5   5   5   5 271   5   5   5   5   5  18
 18   5   5   5   5   5   5   5   5   5   5   5   5   5   5 271   5   5   5   5  18
 18   5   5   5   5   5   5   5   5   5   5   5   5   5   5   5   5   5   5   5  18
 18   5   5   5   5   5   5   5   5   5   5   5   5   5   5   5   5   5   5   5  18
 18   5   5   5   5   5   5   5   5   5   5   5   5   5   5   5   5   5   5   5  18
 18   5   5   5   5   5   5   5   5   5   5   5   5   5   5   5   5   5   5   5  18
 18   5   5   5   5   5   5   5   5   5   5   5   5   5   5   5   5   5   5   5  18
 18   5   5   5   5   5   5   5   5   5   5   5   5   5   5   5   5   5   5   5  18
 18   5   5   5   5   5   5   5   5   5   5   5   5   5   5   5   5   5   5   5  18
 18   5   5   5   5   5   5   5   5   5   5   5   5   5   5   5   5   5   5   5  18

0
1
0 15 9 31 35 Timy's Castle Hall
0
12
276  7 12  0
277  8 16  0
286  8 14  0
288  7 14  0
289  8  4  0
289  8  3  0
289  8  5  0
287  9  3  0
290  9  5  0
291 11  3  0
292 11  4  0
293 11  5  0
2
278  7 12  0
278  8 16  0
