1 1 0 16 25

6
 9  9 66 172
 9 10 66 173
10  9 66 171
10 10 66 172
11  9 66 171
11 10 66 173

229 229 229 229 229 229 229 229 229 229 229 229 229 229 229 229 229 229 229 229 229 229 229 229 229
229 234 232 232 232 232 232 232 232 232 232 232 232 232 232 232 232 232 232 232 232 232 232 235 229
229 230 234 143 144 232 232 232 232 232 232 232 232 232 232 232 232 232 232 232 232 232 235 228 229
229 230 230 141 142 173 173 172 174 171 174 382 170 170 170 170 170 170 169 169 169 169 228 228 229
229 230 230 139 140 173 172 174 171 172 171 186 170 170 170 170 170 170 169 169 169 169 228 228 229
229 230 230 172 173 174 171 171 173 174 172 186 170 170 170 170 170 170 169 169 169 169 228 228 229
229 230 230 172 174 174 174 172 174 172 172 188 189 189 189 189 189 189 189 189 189 189 228 228 229
229 230 230 171 173 173 173 143 144 172 171 174 173 173 173 172 172 171 174 171 172 173 228 228 229
229 230 230 173 173 172 173 141 142 173 172 173 171 172 171 172 173 173 172 172 174 174 228 228 229
229 230 230 171 174 171 173 145 146 143 144 160 161 161 161 161 162 174 174 171 173 174 228 228 229
229 230 230 171 174 171 172 141 142 141 142 163 164 164 164 164 165 173 172 173 172 174 228 228 229
229 230 230 171 174 174 172 145 146 139 140 163 164 164 164 164 165 174 171 174 174 172 228 228 229
229 230 230 174 174 173 172 141 142 384 384 163 164 164 164 164 165 172 174 267 269 174 228 228 229
229 230 230 174 173 174 173 139 140 172 174 166 167 167 167 167 168 171  80 273 275  80 228 228 229
229 227 227 223 224 225 227 227 227 227 227 227 227 227 227 227 227 227 227 227 227 227 227 227 229
229 229 229 229 229 229 229 229 229 229 229 229 229 229 229 229 229 229 229 229 229 229 229 229 229

 33  33  33  33  33  33  33  33  33  33  33  33  33  33  33  33  33  33  33  33  33  33  33  33  33
 33  33  33  33  33  33  33  33  33  33  33  33  33  33  33  33  33  33  33  33  33  33  33  33  33
 33  33  33 232 232  33  33  33  33  33  33  33  33  33  33  33  33  33  33  33  33  33  33  33  33
 33  33  33   1   1   1   1   1   1   1   1   1   1   1   1   1   1   1   1   1   1   1  33  33  33
 33  33  33   1   1   1   1   1   1   1   1   1   1   1   1   1   1   1   1   1   1   1  33  33  33
 33  33  33   1   1   1   1   1   1   1   1   1   1   1   1   1   1   1   1   1   1   1  33  33  33
 33  33  33   1   1   1   1   1   1   1   1   1   1   1   1   1   1   1   1   1   1   1  33  33  33
 33  33  33   1   1   1   1   1   1   1   1   1   1   1   1   1   1   1   1   1   1   1  33  33  33
 33  33  33   1   1   1   1   1   1   1   1   1   1   1   1   1   1   1   1   1   1   1  33  33  33
 33  33  33   1   1   1   1   1   1   1   1   1   1   1   1   1   1   1   1   1   1   1  33  33  33
 33  33  33   1   1   1   1   1   1   1   1   1   1   1   1   1   1   1   1   1   1   1  33  33  33
 33  33  33   1   1   1   1   1   1   1   1   1   1   1   1   1   1   1   1   1   1   1  33  33  33
 33  33  33   1   1   1   1   1   1 172 174   1   1   1   1   1   1   1   1   1   1   1  33  33  33
 33  33  33   1   1   1   1   1   1   1   1   1   1   1   1   1   1   1   1   1   1   1  33  33  33
 33  33  33  33  33  33  33  33  33  33  33  33  33  33  33  33  33  33  33  33  33  33  33  33  33
 33  33  33  33  33  33  33  33  33  33  33  33  33  33  33  33  33  33  33  33  33  33  33  33  33

0
1
0 14  4 3 7 Dungeon26
0
4
385 12 19 0
386 12 20 0
387 13 19 0
388 13 20 0
3
278 13 19 0
278 13 20 0
389  2  8 1 65
